wwwwwwwwwwwwwwwwwwwwwww
w          p          w
w                     w
w                     w 
w      wwwwwwwww      w
w   o  w       w   o  w
w   h  w       w   h  w
w   o  w       w   o  w
w      wwwwwwwww      w
w                     w
w                     w
wwwwwwwwwwwwwwwwwwwwwww