wwwwwwwwwwwwwwwwwww
w        p        w
w                 w
w                 w 
w        o     0  w
w                 w
w        h        w
wwwwwwwwwwwwwwwwwww