    wwwwwwwwwwwwwwwwwww
    w        p        w
    w                 w
    w                 w 
wwwww      wwwww      wwwww
w          w   w          w
wh 0       w   w       0 hw
w          w   w          w
wwwww      wwwww      wwwww
    w                 w
    w                 w
    wwwwwwwwwwwwwwwwwww
  